EMERALD VEIN
8 12
7  7  7  7  7  7  7  7
7  7  1  1  0  0  1  7
7  7  0  1  2  1  1  7
7  2  1  8  2  3  0  7
7  3  3  3  3  3  2  7
7  2  2  3  3  3  3  7
7  1  3  3  3  2  3  7
7  3  7  1  3  3  2  7
7  2  3  3  7  1  3  7
7  3  1  2  0  1  2  7
7  7  3  1  3  3  7  7
7  7  7  7  7  5  7  7
24 1000
