LEVEL
EMERALD QUARRY
9 9
7  7  7  7  7  7  7  7  7
7  0  0  0  0  0  0  0  7
7  0  2  0  8  0  0  0  7
7  3  3  2  0  0  0  2  7
7  2  3  3  3  3  3  3  7
7  3  3  3  3  3  2  2  7
7  2  2  3  3  3  3  7  7
7  7  3  3  3  7  7  7  7
7  7  7  5  7  7  7  7  7
20 1000
