lots of rocks
8 10
7  7  7  7  7  7  7  7 
7  1  1  1  1  1  5  7 
7  3  2  3  2  3  2  7 
7  2  3  2  3  2  3  7 
7  3  2  3  2  3  2  7 
7  2  3  2  3  2  3  7 
7  1  1  1  1  1  1  7 
7  1  1  7  7  1  1  7 
7  8  1  1  1  1  1  7 
7  7  7  7  7  7  7  7
10 100
