LEVEL
TRICK
7 6
7 7 7 7 7 7 7
7 2 2 2 3 3 7
7 3 3 3 3 3 7
7 3 2 2 5 3 7
7 3 3 3 7 8 7
7 7 7 7 7 7 7
12 300
