LEVEL
BOMBARDMENT
INSANE
8 11 5 1000
2  2  2  2  2  13 2  2
2  6  6  2  6  1  8  2
2  6  4  8  1  8  4  2
2  8  9  3  3  3  7  2
2  8  3  0  15 0  3  2
2  4  0  0  2  7  9  2
2  0  1  10 0  1  1  2
2  1  7  0  1  6  1  2
2  1  1  3  3  1  3  2
2  9  1  10 8  0  3  2
2  2  2  2  2  2  2  2
