LEVEL
TUTORIAL 1
TUTORIAL
10 8 7 1000
2  2  2  2  2  2  2  2  2  2
2  2  6  10 2  10 6  3  13  2
2  15 1  2  2  6  6  6  2  2
2  2  0  2  7  7  1  1  1  2
2  0  7  0  2  2  2  2  1  2
2  3  2  9  1  1  6  6  9  2
2  1  1  1  2  1  7  1  7  2
2  2  2  2  2  2  2  2  2  2
