LEVEL
DOUBLE TROUBLE 1
EASY
8 5 1 1000
2  2  2  2  2  2  2  2
2  1  6  1  1  1  1  2
2  0  13 13 1  1  1  2
2  0  15 15 0  0  9  2
2  2  2  2  2  2  2  2
